[
  [" "," "," "," "," "," "," "," "," ","w"," "," "," "," "," "," ","a"," "," "," "],
  [" "," "," "," "," "," "," "," "," ","w","a","w","w","w","w","w","w","w","w"," "],
  [" "," "," "," "," "," "," "," "," ","w"," ","w"," "," "," "," ","a"," ","w"," "],
  [" "," "," "," "," "," "," "," "," ","w","a","w"," ","w","w","w","w"," ","w"," "],
  [" "," "," "," "," "," "," "," "," ","w"," ","w"," ","w","w","w","w"," ","w"," "],
  [" "," "," "," "," ","p"," "," "," ","w"," ","w","a","w","w","w","w"," ","w"," "],
  [" "," "," "," "," "," "," "," "," ","w"," ","w","w","w","w","w","w"," ","w"," "],
  [" "," "," "," "," "," "," "," "," ","w"," ","w","w","w","w","w","w"," ","w"," "],
  [" "," "," "," "," "," "," "," "," ","w"," "," ","a"," "," "," "," "," ","w"," "],
  [" "," "," "," "," "," "," "," "," ","w","w","w","w","w","w","w","w","w","w"," "],
  [" "," "," "," "," "," "," "," "," "," "," "," "," "," "," "," "," "," "," "," "]
]
